WE we.png
SO so.png
NO no.png
EA ea.png

C   39,153,245
F 91, 110,100




11111111111111111111111111111111111111111
111111111111111000000000000000001111111111
1000100000000000000000010000000000000011
100010000000000000000001000000000000E0011
10001000000000000000000100000000000000111
10001000000000000000000100000000000000111
10001000000000000000000100000000000000111
10001000000000000000000100000000000000111
10001000000000000000000100000000000000111
10001000000000000000000100000000000000111
10001000000000000000000100000000000000111
10001000000000000000000100000000000000111
10001000000000000000000100000000000000111
10001000000000000000000100000000000000111
10001000000000000000000100000000000000111
10001000000000000000000100000000000000111
10001000000000000000000100000000000000111
10001000000000000000000100000000000000111
10001000000000000000000100000000000000111
10001000000000000000000100000000000000111
10001000000000000000000100000000000000111
10001000000000000000000100000000000000111
11111111111111111111111111111111111111111111





