C   150,11,0
F 123,10,0
WE ./pics/bluestone.png
SO		./pics/wood.png



NO  ./pics/eagle.png



EA ./pics/redbrick.png








11111111111111111111111111111111111111111
111111111111111000000000000000001111111111
10001000000000000000000100000000000000011
10001000000000000000001000000000000011111
1000100000000011111111100000000000000011111
1000100000000011111111111111111111100001
1000100000000011111111111111111111111111111111
1000100000000011111111111111111111111111
100010000000001111111111111111111000000011111
100010000000001111111111111111111000000000001111111
1111111111111111111111111111111111111111111111