SO   ./pics/wood.png



WE ./pics/bluestone.png


C   150  ,  11,   12


NO  ./pics/eagle.png

EA ./pics/redbrick.png

F 0         ,15   ,    170









1111111111   1111111111111111111111111111111
11111111111111100000000000000000011111
100010000000000000000001000000000001
10001000000000000000001000000000000011111
1000100000000011111111100000000000000011111
1000100000000011111111111111111111100001
1000100000000011111111111111111111111111111111
100010000000001111111111N111111111111111
100010000000001111111111111111111000000011111
100010000000001111111111111111111000000000001111111
1111111111111111111111111111111111111111111111
