WE we.png
SO so.png
NO no.png
EA ea.png

F 55, 44,89

C   10,0,11










11111111111111111111111111111111111111111
111111111111111000000000000000001111111111
10001000000000000000000100000000000000011
10001000000N00000000001000000000000011111
1000100000000011111111100000000000000011111
10001000000000111111111111111111111000011
1000100000000011111111111111111111111111111111
1000100000000011111111111111111111111111
1000100000000011111111111111111110000000111111
10001000000000111111111101111 11111000000000001111111
1111111111111111111111111111111111111111111111




