C   255,255,255
F 0,0,0
WE ./pics/bluestone.png
SO		./pics/wood.png



NO  ./pics/eagle.png



EA ./pics/redbrick.png






11111111111111111111111111111111111111111
111111111111111000000000000000001111111111
10001000000000000000000100000000000000011
10001000000000000S00001000000000000011111
1000100000000011111111100000000000000011111
10001000000000111111111111111111111000011
1000100000000011111111111111111111111111111111
1000100000000011111111111111111111111111
1000100000000011111111111111111110000000111111
10001000000000111111111101111 11111000000000001111111
1111111111111111111111111111111111111111111111




