NO  pngs/no.png
SO  pngs/so.png
EA  pngs/ea.png
WE  pngs/we.png
F 91,110,105
C 39,153,245




111111111
1000S0001
100000001
100000001
100000001
100000001
100000001
100000001
100000001
100000001
100000001
100000001
100000001
100000001
100000001
100000001
100000001
100000001
100000001
100000001
100000001
100000001
100000001
100000001
100000001
100000001
100000001
100000001
100000001
100000001
100000001
100000001
100000001
100000001
100000001
100000001
100000001
100000001
100000001
100000001
100000001
100000001
100000001
100000001
100000001
100000001
100000001
100000001
100000001
100000001
100000001
100000001
100000001
100000001
100000001
100000001
100000001
100000001
100000001
100000001
100000001
100000001
100000001
100000001
100000001
100000001
100000001
100000001
100000001
100000001
100000001
100000001
100000001
100000001
100000001
100000001
100000001
100000001
100000001
100000001
100000001
100000001
100000001
100000001
100000001
100000001
100000001
100000001
100000001
100000001
100000001
100000001
100000001
100000001
100000001
100000001
100000001
100000001
100000001
100000001
100000001
100000001
100000001
100000001
100000001
100000001
100000001
100000001
100000001
100000001
100000001
100000001
100000001
100000001
100000001
100000001
100000001
100000001
100000001
100000001
100000001
100000001
100000001
100000001
100000001
100000001
100000001
100000001
100000001
100000001
100000001
100000001
100000001
100000001
100000001
100000001
100000001
100000001
100000001
100000001
100000001
100000001
100000001
100000001
100000001
100000001
100000001
100000001
100000001
100000001
100000001
100000001
100000001
100000001
100000001
100000001
100000001
100000001
100000001
100000001
100000001
100000001
100000001
100000001
100000001
100000001
100000001
100000001
100000001
100000001
100000001
100000001
100000001
100000001
100000001
100000001
100000001
100000001
100000001
100000001
100000001
100000001
100000001
100000001
100000001
100000001
100000001
100000001
100000001
100000001
100000001
100000001
100000001
100000001
100000001
100000001
100000001
100000001
100000001
111111111